Z                            Z|
                              |
    ZZZ                       |
    ZZZ                       |
    ZZZZZZ  E                 |
ZZZZZZZZZZZZZZZZZZZ Z Z Z     |
Z               I             |
Z               I            Z|
Z               I            Z|
Z               I            Z|
Z               I            Z|
Z               I  E   E     Z|
ZZZZZZZZZZZZZZZZZZZZZZZZZ    Z|
Z                     I      Z|
Z                     I     VZ|
Z    E A   L  F  E    I      Z|
ZZZZZZZZZZZZZZZZZZZZZZZZ   ZZZ|
ZZ                        ZZZZ|
ZZ  P                    ZZZZZ|
ZZZZZZZZZZV         V  ZZZZZZZ|
ZZZ  V  I          ZZZZZZZZZZZ|
ZZZ     I      A  ZZZZZZZZZZZZ|
ZZZZZ   I   ZZZZZZZZZZZZZZZZZZ|
ZZZ     I  ZZZZZZZZZZZZZZZZZZZ|
ZZZ  E  I VZZZZZZZZZZZZZZZZZZZ|
ZZZZZZZZZZZZZZZZZZZZZZZZZZZZZZ|
ZZZZZZZZZZZZZZZZZZZZZZZZZZZZZZ|
ZZZZZZZZZZZZZZZZZZZZZZZZZZZZZZ|
ZZZZZZZZZZZZZZZZZZZZZZZZZZZZZZ|
ZZZZZZZZZZZZZZZZZZZZZZZZZZZZZZ|
------------------------------+