ZZZZZZZZZZZZZZZZZZZZZZZZZZZZZZ|
ZZZZZZZZZZZZZZZZZZZZZZZZZZZZZZ|
ZZZZZZV           I        ZZZ|
ZZZZV             T         ZZ|
Z                        L  ZZ|
Z F                      Z  ZZ|
ZZZZZDZZZZZZVVVVVVVVVVVVVZVVZZ|
ZZZZZHZZZZZZZZZZZZZZZZZZZZZZZZ|
ZZZ  H    T ZZZZZZZZZZZZZZZZZZ|
ZZZV H       ZZZZZZZZZZZZZZZZZ|
ZZZ  H     A ZZZZZZZZZZZZZZZZZ|
ZZZ  H  ZZZZZZZZZZZZZZZZZZZZZZ|
ZZZ  H  I     ZZZZZZZZZZZZZZZZ|
ZZZV H  I     ZZZZZZZZZZZZZZZZ|
ZZZ  Z  I     ZZZZZZZZZZZZZZZZ|
ZZZVVZV Z     ZZZZZZZZZZZZZZZZ|
ZZZZZZZZZZZZDZZZZZZZZZZZZZZZZZ|
ZZZZZZZ I   H       ZZZZZZZZZZ|
ZZZZZ   I   H       ZZZZZZZZZZ|
ZZZZZ   I   H     A ZZZZZZZZZZ|
ZZZZZ   T  ZZZZZZZDZZZZZZZZZZZ|
ZZZZZZ      I     H ZZZZZZZZZZ|
ZZZZZZ  P   I     H ZZZZZZZZZZ|
ZZZZZZZZZZ  IE    H ZZZZZZZZZZ|
ZZZZZZZZZZZZZZZZZZZZZZZZZZZZZZ|
ZZZZZZZZZZZZZZZZZZZZZZZZZZZZZZ|
ZZZZZZZZZZZZZZZZZZZZZZZZZZZZZZ|
ZZZZZZZZZZZZZZZZZZZZZZZZZZZZZZ|
ZZZZZZZZZZZZZZZZZZZZZZZZZZZZZZ|
ZZZZZZZZZZZZZZZZZZZZZZZZZZZZZZ|
------------------------------+