ZZZZZZZZZZZZZZZZZZZZZZZZZZZZZZ|
ZZZZZZZZZZZZZZZ   ZZZ   ZZZZZZ|
ZZZZZZZZZZZZZZZ    V     V ZZZ|
ZZZZZZZZZZZZZZZ V     V    ZZZ|
ZZZZZZZZZZZZZZZ ZZZZZZZZZZDZZZ|
ZZZZZZZZZZZZZZZLZZZZZZZZZZHZZZ|
ZZZZZZZZZZZZZZZ ZZZZZZZZZZHZZZ|
ZZZZZZZZZZZZZZZ ZZZZZZZZZZHZZZ|
ZZZZZZZZZZZZZZZ ZZZZZZZZZZHZZZ|
ZZZZZZZZZZZZZZ   ZZZZZZZZZHZZZ|
ZZZZZZZZZZZZZ     ZZZZZZZZHZZZ|
ZZZZZZZZZZZZZ  F  ZZZZZZZZHZZZ|
ZZZZZZZZZZZZZZZDZZZZZZZZZZHZZZ|
ZZZZZZZZ  I  I H I   I  ZZHZZZ|
ZZZZZZZZV I  I H I   I VZZHZZZ|
ZZZZZZZZV T  IZZZI   T VZZHZZZ|
ZZZ          ZBZBZ        H ZZ|
ZZZ            Z          H ZZ|
ZZZR           Z          HRZZ|
ZZZZZ       DZZZZZD       ZZZZ|
ZZZZZ       H  Z  H       ZZZZ|
ZZZZZZZZZ   H  T  H   ZZZZZZZZ|
ZZZZZZZZZ  AH     HA  ZZZZZZZZ|
ZZZZZZZZZZZZZ     ZZZZZZZZZZZZ|
ZZZZZZZZZZZZZ  P  ZZZZZZZZZZZZ|
ZZZZZZZZZZZZZZZZZZZZZZZZZZZZZZ|
ZZZZZZZZZZZZZZZZZZZZZZZZZZZZZZ|
ZZZZZZZZZZZZZZZZZZZZZZZZZZZZZZ|
ZZZZZZZZZZZZZZZZZZZZZZZZZZZZZZ|
ZZZZZZZZZZZZZZZZZZZZZZZZZZZZZZ|
------------------------------+