ZZZZZZZZZZZZZZZZZZZZZZZZZZZZZZ|
ZZZZZZZZZZZZZZZZZZZZZZZZZZZZZZ|
ZZZZZZZZZZZZ   T     T B  ZZZZ|
ZZZZZZZZZZZZ              ZZZZ|
ZZZZZZZZZZZZ             AZZZZ|
ZZZZZZZZZZZZZDZZZDZZV  ZZZZZZZ|
ZZZZZZZZZZZZZHZZZHZZZZZZZZZZZZ|
ZZZZZZZ   V  H   H  V   ZZZZZZ|
ZZZZZZ       H   H       ZZZZZ|
ZZZZZZ       H   H       ZZZZZ|
ZZZZZZ  A    H F H    A  ZZZZZ|
ZZZZZZZZZ    DZZZD    ZZZZZZZZ|
ZZZZZZB I    HI IH    I  ZZZZZ|
ZZZZZZ  T    HI IH    T  ZZZZZ|
ZZZZZZ  I    HIPIH    IE ZZZZZ|
ZZZZZZZZZ    DZZZD    ZZZZZZZZ|
ZZZZB   Z    HITIH    ZZZZZZZZ|
ZZZZ    Z    HI IH    ZZZZZZZZ|
ZZZZV        HI IH  R ZZZZZZZZ|
ZZZZZZZZZZZZZZZDZZZZZZZZZZZZZZ|
ZZZZZZZZZZZZZZZHZZZZZZZZZZZZZZ|
ZZZZZZZZZZZZZZZH   VVZZVV   ZZ|
ZZZZZZZZZZZZZZZH     ZZ   L ZZ|
ZZZZZZZZZZZZZZZH     ZZ     ZZ|
ZZZZZZZZZZZZZZZZZ    VV     ZZ|
ZZZZZZZZZZZZZZZZZ         ZZZZ|
ZZZZZZZZZZZZZZZZZV        VZZZ|
ZZZZZZZZZZZZZZZZZZV      VZZZZ|
ZZZZZZZZZZZZZZZZZZZVVVVVVZZZZZ|
ZZZZZZZZZZZZZZZZZZZZZZZZZZZZZZ|
------------------------------+