Z                            Z|
                              |
                              |
                              |
            E                 |
ZZZZZZZZZZZZZZZZZZZ Z Z Z     |
Z                             |
Z                             |
Z                            Z|
Z                            Z|
Z                            Z|
Z                  E   E     Z|
ZZZZZZZZZZZZZZZZZZZZZZZZZ    Z|
Z                            Z|
Z                            Z|
Z    E A      F  E           Z|
ZZZZZZZZZZZZZZZZZZZZZZZZ   ZZZ|
ZZ                        ZZZZ|
ZZ  P                    ZZZZZ|
ZZZZZZZZZZ             ZZZZZZZ|
ZZZ                ZZZZZZZZZZZ|
ZZZ            A  ZZZZZZZZZZZZ|
ZZZZZ       ZZZZZZZZZZZZZZZZZZ|
ZZZ        ZZZZZZZZZZZZZZZZZZZ|
ZZZ  E     ZZZZZZZZZZZZZZZZZZZ|
ZZZZZZZZZZZZZZZZZZZZZZZZZZZZZZ|
ZZZZZZZZZZZZZZZZZZZZZZZZZZZZZZ|
ZZZZZZZZZZZZZZZZZZZZZZZZZZZZZZ|
ZZZZZZZZZZZZZZZZZZZZZZZZZZZZZZ|
ZZZZZZZZZZZZZZZZZZZZZZZZZZZZZZ|
------------------------------+