ZZZZZZZZZZZZZZZZZZZZZZZZZZZZZZ|
ZZZZZZZZZZZZZZZZZZZZZZZZZZZZZZ|
ZZZZZZZZZZZZZZZZZZZZZZZZZZZZZZ|
ZZZZZZZZZZZZZZZZZZZZZZZZZZZZZZ|
ZZZZZZZZZZZZZZZZZZZZZZZZZZZZZZ|
ZZZZZZZZZZZZZZZZZZZZZZZZZZZZZZ|
ZZZZZV  B  IV  VI     V  ZZZZZ|
ZZZZZ      I    I          ZZZ|
ZZZZV      T    I          IZZ|
ZZZZ            I          I Z|
ZZZZ   FF       I          T Z|
ZZZZZZZZZZZ     IA     E     Z|
ZZZZZZZZZZZZZZZZZZZZDZZZZ    Z|
ZZZZZZZZZZZZ    B   H I      Z|
ZZZZZZZZZZZZ        H T     VZ|
ZZZZZZZZZZZZ        HRI      Z|
ZZZZZZZZZZZZZDZZZZZZZZZZ   ZZZ|
ZZ           H        I   ZZZZ|
ZZ  P        H        T  ZZZZZ|
ZZZZZZZZZZV  H      V IZZZZZZZ|
ZZZZZZZZZZ   H     ZZZZZZZZZZZ|
ZZZ I    V   H A  ZZZZZZZZZZZZ|
ZZZ T       ZZZZZZZZZZZZZZZZZZ|
ZZZ        ZZZZZZZZZZZZZZZZZZZ|
ZZZ   V   VZZZZZZZZZZZZZZZZZZZ|
ZZZ   ZZZZZZZZZZZZZZZZZZZZZZZZ|
ZZZ  VZZZZZZZZZZZZZZZZZZZZZZZZ|
ZZZ L ZZZZZZZZZZZZZZZZZZZZZZZZ|
ZZZ   ZZZZZZZZZZZZZZZZZZZZZZZZ|
ZZZZZZZZZZZZZZZZZZZZZZZZZZZZZZ|
------------------------------+