ZZZZZZZZZZZZZZZZZZZZZZZZZZZZZZ|
ZZZZZZZZZZZZZZZZZZZZZZZZZZZZZZ|
ZZZZZZZZZZZZZZZZZZZZZZZZZZZZZZ|
ZZZZZZ   B I   I   I V  ZZZZZZ|
ZZZZZZ     I   T   I    ZZZZZZ|
ZZZZZZ     I   I   I    ZZZZZZ|
ZZZZZZ  ZZZZZZZZZZZZZDZZZZZZZZ|
ZZZZZZ  ZZZZZZZZZZZZZH  ZZ V Z|
ZZZZZZ  ZZH   B  H ZZH       Z|
ZZZZZZ  ZZH      H ZZH   A   Z|
ZZZZZZ  ZZH      H ZZH  ZZ V Z|
ZZZZZZ  ZZHVZZZZZH ZZH  ZZZZLZ|
ZZZZZZ  ZZHVZZZZZH ZZH    ZZ Z|
ZZZZZZ  ZZHVZZ   H ZZH   AZZ Z|
ZZZZZZ  ZZHVZZ   H ZZH  ZZZZ Z|
ZZZZZZ  ZZHVZZ P H ZZH  ZZZZ Z|
ZZZZZZ  ZZHVZZZZZZZZZH  I  I Z|
ZZZZZZ  ZZHVZZZZZZZZZZ  IA I Z|
ZZZZZZ  ZZH         I   ZZZZZZ|
ZZZZZZ  ZZH         T  ZZZZZZZ|
ZZZZZZ  ZZH      R  I ZZZZZZZZ|
ZZZZZZ  ZZZZZZZZZZZZZZZZZZZZZZ|
ZZZZZZ  ZZZZZZZZZZZZZZZZZZZZZZ|
ZZZZZZ  I VVVVVVVVVVVVVVV ZZZZ|
ZZZZZZ  I                 ZZZZ|
ZZZZZZZZZ           A   F ZZZZ|
ZZZZZZZZZZZZZZZZZZZZZZZZZZZZZZ|
ZZZZZZZZZZZZZZZZZZZZZZZZZZZZZZ|
ZZZZZZZZZZZZZZZZZZZZZZZZZZZZZZ|
ZZZZZZZZZZZZZZZZZZZZZZZZZZZZZZ|
------------------------------+