ZZZZZZZZZZZZZZZZZZZZZZZZZZZZZZ|
ZZZZZZZZZZZZZZZZZZZZZZZZZZZZZZ|
ZZZZZZZZZZZZZZZZZZZZZZZZZZZZZZ|
ZZZZZZZZZZZZZZZZZZZZZZZZZZZZZZ|
ZZZZZZZZZZZZZZZZZZZZZZZZZZZZZZ|
ZZZZZZZZZZZV      I  ZZZZZZZZZ|
ZZZZZZZZZZ        T  VZZZZZZZZ|
ZZZZZZZZZV             ZZZZZZZ|
ZZZZZZZZZ       F      ZZZZZZZ|
ZZZZZZZZZ   ZZDZZZZZ   ZZZZZZZ|
ZZZZZZZZZ   ZZHZZZZZ   ZZZZZZZ|
ZZZZ T ZZ   ITH    I   ZZZZZZZ|
ZZZZ L ZZ   I H    I   ZZZZZZZ|
ZZZZ   ZZ  RI H    IZZ ZZZZZZZ|
ZZZZDZZZZ ZZZZZZZZZDZZ ZZZZZZZ|
ZZZZH  VZ ZZZZZZZZZHZZ ZZZZZZZ|
ZZZZH  ZZ I    I  THBI ZZZZZZZ|
ZZZZHV ZZ I    T   H I ZZZZZZZ|
ZZZZZZDZZ I        H I ZZZZZZZ|
ZZZZV HZZ I     A  H I ZZZZZZZ|
ZZZZ  HZZ I P ZZZ  H IRZZZZZZZ|
ZZZZV HZZZZZZZZZZZZDZZZZZZZZZZ|
ZZZZZDZZZZZZZZZZZZZHZZZZZZZZZZ|
ZZZZ H    V        H  VZZZZZZZ|
ZZZZ H             H   ZZZZZZZ|
ZZZZ H    E E E        ZZZZZZZ|
ZZZZZZZZZZZZZZZZZZZZZZZZZZZZZZ|
ZZZZZZZZZZZZZZZZZZZZZZZZZZZZZZ|
ZZZZZZZZZZZZZZZZZZZZZZZZZZZZZZ|
ZZZZZZZZZZZZZZZZZZZZZZZZZZZZZZ|
------------------------------+