ZZZZZZZZZZZZZZZZZZZZZZZZZZZZZZ|
ZZZZZZZZZZZZZZZZZZZZZZZZZZZZZZ|
ZZZZZZZZZZZZZZZZZZZZZZZZZZZZZZ|
ZZZZZZ              I   ZZZZZZ|
ZZZZZ               I    ZZZZZ|
ZZZZZ  P            I     ZZZZ|
ZZZZZZZZZZZZZZZ     Z      ZZZ|
ZZZZZZZZZZZZZZZZZDZZZZZ    ZZZ|
ZZZZZZ T ZZZZZ   H   ZZ    ZZZ|
ZZZZZ  L  ZZZZ   H   ZZ   ZZZZ|
ZZZZZ     ZZZZA  H   ZZ    ZZZ|
ZZZZZZZZZDZZZZZZZDZZZZZZ   ZZZ|
ZZZZZZZZZHZZZZZZZHZZZZZ    ZZZ|
ZZZZZZZZZHZ      H ZZZZ   ZZZZ|
ZZZZZZZZZHZ      H ZZZZ    ZZZ|
ZZZZZ T  HZ      H ZZZZZ   ZZZ|
ZZZZV    HZ R    H ZZZZ    ZZZ|
ZZZ      HZZDZZZZZZZZZZ   ZZZZ|
ZZ      ZZZZHZZZZZZZZZZ    ZZZ|
ZZ   VVVZZZZH  I  ZZZZZZ   ZZZ|
ZZ   ZZZZZZZH  I    ZZV    ZZZ|
ZZ        ZZH  T    ZZ    ZZZZ|
ZZZ         H       ZZ     ZZZ|
ZZZ       ZZH       ZZ     ZZZ|
ZZZ      ZZZH    R VZZE F  ZZZ|
ZZZVVVVVVVZZZZZZZZZZZZZZZZZZZZ|
ZZZZZZZZZZZZZZZZZZZZZZZZZZZZZZ|
ZZZZZZZZZZZZZZZZZZZZZZZZZZZZZZ|
ZZZZZZZZZZZZZZZZZZZZZZZZZZZZZZ|
ZZZZZZZZZZZZZZZZZZZZZZZZZZZZZZ|
------------------------------+