ZZZZZZZZZZZZZZZZZZZZZZZZZZZZZZ|
ZZZZZZZZZZZZZZZZZZZZZZZZZZZZZZ|
ZZZZZZZZ   I    ZZZZZZZZZZZZZZ|
ZZZZZZZ    T     ZZZZZZZZZZZZZ|
ZZZZZZZ          ZZZZZZZZZZZZZ|
ZZZZZZZ   E   F  ZZZZZZZZZZZZZ|
ZZZZZZZZDZZZZZZZZZZZZZZZZZZZZZ|
ZZZZZZZ H ZZZZZZZZZZZZZZZZZZZZ|
ZZZZZZZ H ZZZZZZZZZZZZZZZZZZZZ|
ZZZZZZZ H   Z       VZZZZZZZZZ|
ZZZZZZZ H   B        VZZZZZZZZ|
ZZZZZZZ H              VZZZZZZ|
ZZZZZZZ                 ZZZZZZ|
ZZZZZZZ                 Z I ZZ|
ZZZZZZZ   ZZZZZZZZZ     Z T ZZ|
ZZZZZZZ   I       ZZ        ZZ|
ZZZZZZZ   I     L ZZZ       ZZ|
ZZZZZZZVVVZZZZV   ZZZZ      ZZ|
ZZZZZZZZZZZZZZZZZZZZZZZZZZDZZZ|
ZZZZZZZZZZZZZZZZZZZZZZZZZZHZZZ|
ZZZVV  V     Z     Z      H ZZ|
ZZ           T     T      H ZZ|
ZZ                        H ZZ|
ZZ  P                     H ZZ|
ZZZZZZZZ                 ZZZZZ|
ZZZZZZZZVVVVVVVVVVVVVVVVVZZZZZ|
ZZZZZZZZZZZZZZZZZZZZZZZZZZZZZZ|
ZZZZZZZZZZZZZZZZZZZZZZZZZZZZZZ|
ZZZZZZZZZZZZZZZZZZZZZZZZZZZZZZ|
ZZZZZZZZZZZZZZZZZZZZZZZZZZZZZZ|
------------------------------+